13 27
###########################
#p     sflb  1 *   *  b * #
#d#i#j#*# # #*#*# # # #*#*#
#  x      *b*  *      *   #
# # # # # #*# # #*#*# # # #
#   f      * **  *  *     #
# # # # # # # # # #*# #*# #
#*         *  *      *    #
# # #*# #*# # # #*#*# # # #
#*    *f  *       *       #
# #*# # # # # # #*# # # # #
#           s   *  *      #
###########################