13 27
###########################
#p   3 ** *  1 * 2 *  * * #
# # # #*# # #*#*# # # #*#*#
#  x*     ***  *  1   * 2 #
# # # # # #*# # #*#*# # # #
#f         * **  *  *   1 #
# # # # # # # # # #*# #*# #
#*  *      *  *      *    #
# # #*# #*# # # #*#*# # # #
#*    **  *       *       #
# #*# # # # # # #*# # # # #
#   1       *   *  *      #
###########################