13 27
###########################
#p   3 s* *  1 * 2 *  b * #
# # # #*# # #*#*# # # #*#*#
#  x*     *b*  *  1   * 2 #
# # # # # #*# # #*#*# # # #
#   f      * **  *  *   1 #
# # # # # # # # # #*# #*# #
#*         *  *      *    #
# # #*# #*# # # #*#*# # # #
#*    *f  *       *   3   #
# #*# # # # # # #*# # # # #
#   1       s 3 *  *      #
###########################