13 27
###########################
#p     sflb  1 *   *  b * #
#d#i#j#*# # #*#*# # # #*#*#
#  x      *b*  *      * 2 #
# # # # # #*# # #*#*# # # #
#   f      * **  *  *   3 #
# # # # # # # # # #*# #*# #
#*     5   *  *      *    #
# # #*# #*# # # #*#*# # # #
#*    *f  *       *   6   #
# #*# # # # # # #*# # # # #
#   4       s   *  *      #
###########################