13 27
###########################
#p             *   *    * #
# # # #*# # #*#*# # # #*#*#
#  x      * *  *      *   #
# # # # # #*# # #*#*# # # #
#          * **  *  *     #
# # # # # # # # # #*# #*# #
#*         *  *      *    #
# # #*# #*# # # #*#*# # # #
#*    *   *       *       #
# #*# # # # # # #*# # # # #
#               *  *      #
###########################