17 27
###########################
#p   3 ** s    * 4 *  b * #
# # # #*# # #*#*# # # #*#*#
#   *  1  b*d  *  5*  * 2 #
# # # # # # # # #*# # # # #
#   f  *  *  2   *  d     #
# # # # # # # # # #*# #*# #
#*   ** 3  *  *      *    #
# # #*# #*# # # #*#*# # # #
#*    *f6 * *     *       #
# #*# # # # # # #*# #1# # #
#   1  s l  *   *  *      #
# # #*#i# #j# #*#*# # #*# #
#     *x*     *  *  3*    #
# #*# # # #s# # # # #2# # #
#    1   l    *   s       #
###########################