17 27
###########################
#p   3 ** s    * 2 *  b * #
# # # #*# # #*#*# # # #*#*#
#   *  1  b**  *  1*  * 2 #
# # # # # # # # #*# # # # #
#   f  *  *  2   *  d     #
# # # # # # # # # #*# #*# #
#*   ** 3  *  *      *    #
# # #*# #*# # # #*#*# # # #
#*    *f3 * *     *       #
# #*# # # # # # #*# #1# # #
#   1  s l  *   *  *      #
# # #*#i# #j# #*#*# # #*# #
#     *x*     *  *  3*    #
# #*# # # #s# # # # #2# # #
#    1   l    *   s       #
###########################