17 27
###########################
#p     **      *   *    * #
# # # #*# # #*#*# # # #*#*#
#   *      **  *   *  *   #
# # # # # # # # #*# # # # #
#      *  *      *        #
# # # # # # # # # #*# #*# #
#*   **    *  *      *    #
# # #*# #*# # # #*#*# # # #
#*    *   * *     *       #
# #*# # # # # # #*# # # # #
#           *   *  *      #
# # #*# # # # #*#*# # #*# #
#     *x*     *  *   *    #
# #*# # # #s# # # # # # # #
#             *           #
###########################