13 27
###########################
#p     sflb  5 *   *  b * #
#d#i#j#*# # #*#*# # # #*#*#
#  x      *b*  *      * 2 #
# # # # # #*# # #*#*# # # #
#   f      * **  *  *   3 #
# # # # # # # # # #*# #*# #
#*     6   *  *      *    #
# # #*# #*# # # #*#*# # # #
#*    *f  *       *   3   #
# #*# # # # # # #*# # # # #
#   4       s   *  *      #
###########################