17 27
###########################
#p   6 ** s    * 5 *  b * #
# # # #*# # #*#*# # # #*#*#
#   *  4  b**  *  4*  * 5 #
# # # # # # # # #*# # # # #
#   f  *  *  5   *  d     #
# # # # # # # # # #*# #*# #
#*   ** 6  *  *      *    #
# # #*# #*# # # #*#*# # # #
#*    *f6 * *     *       #
# #*# # # # # # #*# #4# # #
#   4  s l  *   *  *      #
# # #*#i# #j# #*#*# # #*# #
#     *x*     *  *  6*    #
# #*# # # #s# # # # #5# # #
#    4   l    *   s       #
###########################