17 27
###########################
#p   3 ** s    * 6 *  b * #
# # # #*# # #*#*# # # #*#*#
#   *  4  b**  *  5*  * 6 #
# # # # # # # # #*# # # # #
#   f  *  *  6   *  d     #
# # # # # # # # # #*# #*# #
#*   ** 3  *  *      *    #
# # #*# #*# # # #*#*# # # #
#*    *f3 * *     *       #
# #*# # # # # # #*# #1# # #
#   4  s l  *   *  *      #
# # #*#i# #j# #*#*# # #*# #
#     *x*     *  *  3*    #
# #*# # # #s# # # # #6# # #
#    5   l    *   s       #
###########################